TILEMAP
10 10 							-- Size of tile map in tiles
16 32 							-- Tile size & block size
images/tilemap.png 	-- Tilesheet
4 4 								-- Number of tiles in tilesheet
15,15,15,15,15,15,15,15,15,15,
15,15,15,15,15,15,15,15,0,0,
15,15,0,15,15,0,0,0,0,0,
15,0,0,15,0,0,0,0,0,0,
0,0,0,0,0,0,0,0,0,0,
0,0,0,0,0,0,0,0,0,0,
0,0,0,0,0,0,0,0,0,5,
0,0,0,0,0,7,0,12,12,12,
0,0,0,0,7,7,0,12,12,12,
1,1,1,1,1,1,1,12,12,13

